##########
#S#......#
#.#.######
#.#......#
#.######.#
#......#.#
######.#.#
#......#.#
#.######E#
##########