##########
#S...#...#
#.##.#.#.#
#....#.#.#
#.####.#.#
#.#....#.#
#.#.####.#
#.#......#
#.######E#
##########