#######
#S...E#
#.#.#.#
#.....#
#######