###############
#S....#.......#
#.###.#.#####.#
#...#.#.....#.#
###.#.#####.#.#
#...#.....#.#.#
#.#######.#.#.#
#.#.....#.#.#.#
#.#.###.#.#.#.#
#.#.#...#.#.#.#
#.#.#.###.#.#.#
#.#.#.....#.#.#
#.#.#######.#.#
#...........E##
###############