############
#S.........#
#.########.#
#.#......#.#
#.#.####.#.#
#.#.#....#.#
#.#.#.####.#
#.#.#......#
#.#.######.#
#.#........#
#.########E#
############