##########
#S.......#
###.######
#...#....#
#.###.##.#
#.....##.#
#####.##.#
#.....##.#
#.######E#
##########